15
-1  -1  -1  -1  20  -1  -1  -1  -1  -1  -1  -1  -1  -1  -1
-1  -1  11  -1  -1  40  -1  -1  -1  -1  -1  -1  -1  -1  -1
-1  11  -1  13  -1  -1  33  -1  -1  -1  -1  -1  -1  -1  -1
-1  -1  13  -1  -1  -1  -1  17  -1  -1  -1  -1  -1  -1  -1
20  -1  -1  -1  -1  15  -1  -1  10  -1  -1  -1  -1  -1  -1
-1  40  -1  -1  15  -1  25  -1  -1  -1  -1  -1  -1  -1  -1
-1  -1  33  -1  -1  25  -1  30  -1  33  -1  -1  -1  -1  -1
-1  -1  -1  17  -1  -1  30  -1  -1  -1  16  -1  -1  -1  -1
-1  -1  -1  -1  10  -1  -1  -1  -1  43  -1  10  -1  -1  -1
-1  -1  -1  -1  -1  -1  33  -1  43  -1  19  -1  -1  12  -1
-1  -1  -1  -1  -1  -1  -1  16  -1  19  -1  -1  -1  -1  40
-1  -1  -1  -1  -1  -1  -1  -1  10  -1  -1  -1  10  -1  -1
-1  -1  -1  -1  -1  -1  -1  -1  -1  -1  -1  10  -1  10  -1
-1  -1  -1  -1  -1  -1  -1  -1  -1  12  -1  -1  10  -1  13
-1  -1  -1  -1  -1  -1  -1  -1  -1  -1  40  -1  -1  13  -1
0   0
10  0
20  0
30  0
0   10
10  10
20  10
30  10
0   20
20  20
30  20
0   30
10  30
20  30
30  30
